1111111111111
1C110000000C1
1000011111001
1111011C11011
1P0000E0000Z1
1111111111111
