1111111111111
1CZ10000000C1
1100011111001
1P0011E0000Z1
1111111111111
